.........
.... ....
...   ...
..     ..
...   ...
.... ....
.........
    
 